0
0
1
0
6 4 3 2 7 2 3 0 6 
0 0 0 0 0 0 0 0 0 
0 5 0 0 0 0 4 5 0 
1 0 1 0 1 0 1 0 1 
0 0 0 0 0 0 0 0 0 
0 0 0 0 0 0 0 0 0 
-1 0 -1 0 -1 0 -1 0 -1 
0 -5 0 0 -5 0 0 0 0 
0 0 0 0 0 0 0 0 0 
-6 -4 -3 -2 -7 -2 -3 -4 -6 
